mla	MULT
mul	MULT
b	BRANCH
bl	BRANCH
swp	SWAP
swpb	SWAP
ldr	TRANS
ldrb	TRANS
str	TRANS
strb	TRANS
swi	SWI
mlaeq	MULT
muleq	MULT
beq	BRANCH
bleq	BRANCH
swpeq	SWAP
ldreq	TRANS
streq	TRANS
swieq	SWI
mlane	MULT
mulne	MULT
bne	BRANCH
blne	BRANCH
swpne	SWAP
ldrne	TRANS
strne	TRANS
swine	SWI
mlacs	MULT
mulcs	MULT
bcs	BRANCH
blcs	BRANCH
swpcs	SWAP
ldrcs	TRANS
strcs	TRANS
swics	SWI
mlahs	MULT
mulhs	MULT
bhs	BRANCH
blhs	BRANCH
swphs	SWAP
ldrhs	TRANS
strhs	TRANS
swihs	SWI
mlacc	MULT
mulcc	MULT
bcc	BRANCH
blcc	BRANCH
swpcc	SWAP
ldrcc	TRANS
strcc	TRANS
swicc	SWI
mlalo	MULT
mullo	MULT
blo	BRANCH
bllo	BRANCH
swplo	SWAP
ldrlo	TRANS
strlo	TRANS
swilo	SWI
mlami	MULT
mulmi	MULT
bmi	BRANCH
blmi	BRANCH
swpmi	SWAP
ldrmi	TRANS
strmi	TRANS
swimi	SWI
mlapl	MULT
mulpl	MULT
bpl	BRANCH
blpl	BRANCH
swppl	SWAP
ldrpl	TRANS
strpl	TRANS
swipl	SWI
mlavs	MULT
mulvs	MULT
bvs	BRANCH
blvs	BRANCH
swpvs	SWAP
ldrvs	TRANS
strvs	TRANS
swivs	SWI
mlavc	MULT
mulvc	MULT
bvc	BRANCH
blvc	BRANCH
swpvc	SWAP
ldrvc	TRANS
strvc	TRANS
swivc	SWI
mlahi	MULT
mulhi	MULT
bhi	BRANCH
blhi	BRANCH
swphi	SWAP
ldrhi	TRANS
strhi	TRANS
swihi	SWI
mlals	MULT
mulls	MULT
bls	BRANCH
blls	BRANCH
swpls	SWAP
ldrls	TRANS
strls	TRANS
swils	SWI
mlage	MULT
mulge	MULT
bge	BRANCH
blge	BRANCH
swpge	SWAP
ldrge	TRANS
strge	TRANS
swige	SWI
mlalt	MULT
mullt	MULT
blt	BRANCH
bllt	BRANCH
swplt	SWAP
ldrlt	TRANS
strlt	TRANS
swilt	SWI
mlagt	MULT
mulgt	MULT
bgt	BRANCH
blgt	BRANCH
swpgt	SWAP
ldrgt	TRANS
strgt	TRANS
swigt	SWI
mlale	MULT
mulle	MULT
ble	BRANCH
blle	BRANCH
swple	SWAP
ldrle	TRANS
strle	TRANS
swile	SWI
mlaal	MULT
mulal	MULT
bal	BRANCH
blal	BRANCH
swpal	SWAP
ldral	TRANS
stral	TRANS
swial	SWI
and	REGOP
eor	REGOP
sub	REGOP
rsb	REGOP
add	REGOP
adc	REGOP
sbc	REGOP
rsc	REGOP
tst	REGOP
teq	REGOP
cmp	REGOP
cmn	REGOP
orr	REGOP
mov	REGOP
bic	REGOP
mvn	REGOP
andeq	REGOP
eoreq	REGOP
subeq	REGOP
rsbeq	REGOP
addeq	REGOP
adceq	REGOP
sbceq	REGOP
rsceq	REGOP
tsteq	REGOP
teqeq	REGOP
cmpeq	REGOP
cmneq	REGOP
orreq	REGOP
moveq	REGOP
biceq	REGOP
mvneq	REGOP
andne	REGOP
eorne	REGOP
subne	REGOP
rsbne	REGOP
addne	REGOP
adcne	REGOP
sbcne	REGOP
rscne	REGOP
tstne	REGOP
teqne	REGOP
cmpne	REGOP
cmnne	REGOP
orrne	REGOP
movne	REGOP
bicne	REGOP
mvnne	REGOP
andcs	REGOP
eorcs	REGOP
subcs	REGOP
rsbcs	REGOP
addcs	REGOP
adccs	REGOP
sbccs	REGOP
rsccs	REGOP
tstcs	REGOP
teqcs	REGOP
cmpcs	REGOP
cmncs	REGOP
orrcs	REGOP
movcs	REGOP
biccs	REGOP
mvncs	REGOP
andhs	REGOP
eorhs	REGOP
subhs	REGOP
rsbhs	REGOP
addhs	REGOP
adchs	REGOP
sbchs	REGOP
rschs	REGOP
tsths	REGOP
teqhs	REGOP
cmphs	REGOP
cmnhs	REGOP
orrhs	REGOP
movhs	REGOP
bichs	REGOP
mvnhs	REGOP
andcc	REGOP
eorcc	REGOP
subcc	REGOP
rsbcc	REGOP
addcc	REGOP
adccc	REGOP
sbccc	REGOP
rsccc	REGOP
tstcc	REGOP
teqcc	REGOP
cmpcc	REGOP
cmncc	REGOP
orrcc	REGOP
movcc	REGOP
biccc	REGOP
mvncc	REGOP
andlo	REGOP
eorlo	REGOP
sublo	REGOP
rsblo	REGOP
addlo	REGOP
adclo	REGOP
sbclo	REGOP
rsclo	REGOP
tstlo	REGOP
teqlo	REGOP
cmplo	REGOP
cmnlo	REGOP
orrlo	REGOP
movlo	REGOP
biclo	REGOP
mvnlo	REGOP
andmi	REGOP
eormi	REGOP
submi	REGOP
rsbmi	REGOP
addmi	REGOP
adcmi	REGOP
sbcmi	REGOP
rscmi	REGOP
tstmi	REGOP
teqmi	REGOP
cmpmi	REGOP
cmnmi	REGOP
orrmi	REGOP
movmi	REGOP
bicmi	REGOP
mvnmi	REGOP
andpl	REGOP
eorpl	REGOP
subpl	REGOP
rsbpl	REGOP
addpl	REGOP
adcpl	REGOP
sbcpl	REGOP
rscpl	REGOP
tstpl	REGOP
teqpl	REGOP
cmppl	REGOP
cmnpl	REGOP
orrpl	REGOP
movpl	REGOP
bicpl	REGOP
mvnpl	REGOP
andvs	REGOP
eorvs	REGOP
subvs	REGOP
rsbvs	REGOP
addvs	REGOP
adcvs	REGOP
sbcvs	REGOP
rscvs	REGOP
tstvs	REGOP
teqvs	REGOP
cmpvs	REGOP
cmnvs	REGOP
orrvs	REGOP
movvs	REGOP
bicvs	REGOP
mvnvs	REGOP
andvc	REGOP
eorvc	REGOP
subvc	REGOP
rsbvc	REGOP
addvc	REGOP
adcvc	REGOP
sbcvc	REGOP
rscvc	REGOP
tstvc	REGOP
teqvc	REGOP
cmpvc	REGOP
cmnvc	REGOP
orrvc	REGOP
movvc	REGOP
bicvc	REGOP
mvnvc	REGOP
andhi	REGOP
eorhi	REGOP
subhi	REGOP
rsbhi	REGOP
addhi	REGOP
adchi	REGOP
sbchi	REGOP
rschi	REGOP
tsthi	REGOP
teqhi	REGOP
cmphi	REGOP
cmnhi	REGOP
orrhi	REGOP
movhi	REGOP
bichi	REGOP
mvnhi	REGOP
andls	REGOP
eorls	REGOP
subls	REGOP
rsbls	REGOP
addls	REGOP
adcls	REGOP
sbcls	REGOP
rscls	REGOP
tstls	REGOP
teqls	REGOP
cmpls	REGOP
cmnls	REGOP
orrls	REGOP
movls	REGOP
bicls	REGOP
mvnls	REGOP
andge	REGOP
eorge	REGOP
subge	REGOP
rsbge	REGOP
addge	REGOP
adcge	REGOP
sbcge	REGOP
rscge	REGOP
tstge	REGOP
teqge	REGOP
cmpge	REGOP
cmnge	REGOP
orrge	REGOP
movge	REGOP
bicge	REGOP
mvnge	REGOP
andlt	REGOP
eorlt	REGOP
sublt	REGOP
rsblt	REGOP
addlt	REGOP
adclt	REGOP
sbclt	REGOP
rsclt	REGOP
tstlt	REGOP
teqlt	REGOP
cmplt	REGOP
cmnlt	REGOP
orrlt	REGOP
movlt	REGOP
biclt	REGOP
mvnlt	REGOP
andgt	REGOP
eorgt	REGOP
subgt	REGOP
rsbgt	REGOP
addgt	REGOP
adcgt	REGOP
sbcgt	REGOP
rscgt	REGOP
tstgt	REGOP
teqgt	REGOP
cmpgt	REGOP
cmngt	REGOP
orrgt	REGOP
movgt	REGOP
bicgt	REGOP
mvngt	REGOP
andle	REGOP
eorle	REGOP
suble	REGOP
rsble	REGOP
addle	REGOP
adcle	REGOP
sbcle	REGOP
rscle	REGOP
tstle	REGOP
teqle	REGOP
cmple	REGOP
cmnle	REGOP
orrle	REGOP
movle	REGOP
bicle	REGOP
mvnle	REGOP
andal	REGOP
eoral	REGOP
subal	REGOP
rsbal	REGOP
addal	REGOP
adcal	REGOP
sbcal	REGOP
rscal	REGOP
tstal	REGOP
teqal	REGOP
cmpal	REGOP
cmnal	REGOP
orral	REGOP
moval	REGOP
bical	REGOP
mvnal	REGOP
ands	REGOP
eors	REGOP
subs	REGOP
rsbs	REGOP
adds	REGOP
adcs	REGOP
sbcs	REGOP
rscs	REGOP
tstp	REGOP
teqp	REGOP
cmpp	REGOP
cmnp	REGOP
orrs	REGOP
movs	REGOP
bics	REGOP
mvns	REGOP
andeqs	REGOP
eoreqs	REGOP
subeqs	REGOP
rsbeqs	REGOP
addeqs	REGOP
adceqs	REGOP
sbceqs	REGOP
rsceqs	REGOP
tsteqp	REGOP
teqeqp	REGOP
cmpeqp	REGOP
cmneqp	REGOP
orreqs	REGOP
moveqs	REGOP
biceqs	REGOP
mvneqs	REGOP
andnes	REGOP
eornes	REGOP
subnes	REGOP
rsbnes	REGOP
addnes	REGOP
adcnes	REGOP
sbcnes	REGOP
rscnes	REGOP
tstnep	REGOP
teqnep	REGOP
cmpnep	REGOP
cmnnep	REGOP
orrnes	REGOP
movnes	REGOP
bicnes	REGOP
mvnnes	REGOP
andcss	REGOP
eorcss	REGOP
subcss	REGOP
rsbcss	REGOP
addcss	REGOP
adccss	REGOP
sbccss	REGOP
rsccss	REGOP
tstcsp	REGOP
teqcsp	REGOP
cmpcsp	REGOP
cmncsp	REGOP
orrcss	REGOP
movcss	REGOP
biccss	REGOP
mvncss	REGOP
andhss	REGOP
eorhss	REGOP
subhss	REGOP
rsbhss	REGOP
addhss	REGOP
adchss	REGOP
sbchss	REGOP
rschss	REGOP
tsthsp	REGOP
teqhsp	REGOP
cmphsp	REGOP
cmnhsp	REGOP
orrhss	REGOP
movhss	REGOP
bichss	REGOP
mvnhss	REGOP
andccs	REGOP
eorccs	REGOP
subccs	REGOP
rsbccs	REGOP
addccs	REGOP
adcccs	REGOP
sbcccs	REGOP
rscccs	REGOP
tstccp	REGOP
teqccp	REGOP
cmpccp	REGOP
cmnccp	REGOP
orrccs	REGOP
movccs	REGOP
bicccs	REGOP
mvnccs	REGOP
andlos	REGOP
eorlos	REGOP
sublos	REGOP
rsblos	REGOP
addlos	REGOP
adclos	REGOP
sbclos	REGOP
rsclos	REGOP
tstlop	REGOP
teqlop	REGOP
cmplop	REGOP
cmnlop	REGOP
orrlos	REGOP
movlos	REGOP
biclos	REGOP
mvnlos	REGOP
andmis	REGOP
eormis	REGOP
submis	REGOP
rsbmis	REGOP
addmis	REGOP
adcmis	REGOP
sbcmis	REGOP
rscmis	REGOP
tstmip	REGOP
teqmip	REGOP
cmpmip	REGOP
cmnmip	REGOP
orrmis	REGOP
movmis	REGOP
bicmis	REGOP
mvnmis	REGOP
andpls	REGOP
eorpls	REGOP
subpls	REGOP
rsbpls	REGOP
addpls	REGOP
adcpls	REGOP
sbcpls	REGOP
rscpls	REGOP
tstplp	REGOP
teqplp	REGOP
cmpplp	REGOP
cmnplp	REGOP
orrpls	REGOP
movpls	REGOP
bicpls	REGOP
mvnpls	REGOP
andvss	REGOP
eorvss	REGOP
subvss	REGOP
rsbvss	REGOP
addvss	REGOP
adcvss	REGOP
sbcvss	REGOP
rscvss	REGOP
tstvsp	REGOP
teqvsp	REGOP
cmpvsp	REGOP
cmnvsp	REGOP
orrvss	REGOP
movvss	REGOP
bicvss	REGOP
mvnvss	REGOP
andvcs	REGOP
eorvcs	REGOP
subvcs	REGOP
rsbvcs	REGOP
addvcs	REGOP
adcvcs	REGOP
sbcvcs	REGOP
rscvcs	REGOP
tstvcp	REGOP
teqvcp	REGOP
cmpvcp	REGOP
cmnvcp	REGOP
orrvcs	REGOP
movvcs	REGOP
bicvcs	REGOP
mvnvcs	REGOP
andhis	REGOP
eorhis	REGOP
subhis	REGOP
rsbhis	REGOP
addhis	REGOP
adchis	REGOP
sbchis	REGOP
rschis	REGOP
tsthip	REGOP
teqhip	REGOP
cmphip	REGOP
cmnhip	REGOP
orrhis	REGOP
movhis	REGOP
bichis	REGOP
mvnhis	REGOP
andlss	REGOP
eorlss	REGOP
sublss	REGOP
rsblss	REGOP
addlss	REGOP
adclss	REGOP
sbclss	REGOP
rsclss	REGOP
tstlsp	REGOP
teqlsp	REGOP
cmplsp	REGOP
cmnlsp	REGOP
orrlss	REGOP
movlss	REGOP
biclss	REGOP
mvnlss	REGOP
andges	REGOP
eorges	REGOP
subges	REGOP
rsbges	REGOP
addges	REGOP
adcges	REGOP
sbcges	REGOP
rscges	REGOP
tstgep	REGOP
teqgep	REGOP
cmpgep	REGOP
cmngep	REGOP
orrges	REGOP
movges	REGOP
bicges	REGOP
mvnges	REGOP
andlts	REGOP
eorlts	REGOP
sublts	REGOP
rsblts	REGOP
addlts	REGOP
adclts	REGOP
sbclts	REGOP
rsclts	REGOP
tstltp	REGOP
teqltp	REGOP
cmpltp	REGOP
cmnltp	REGOP
orrlts	REGOP
movlts	REGOP
biclts	REGOP
mvnlts	REGOP
andgts	REGOP
eorgts	REGOP
subgts	REGOP
rsbgts	REGOP
addgts	REGOP
adcgts	REGOP
sbcgts	REGOP
rscgts	REGOP
tstgtp	REGOP
teqgtp	REGOP
cmpgtp	REGOP
cmngtp	REGOP
orrgts	REGOP
movgts	REGOP
bicgts	REGOP
mvngts	REGOP
andles	REGOP
eorles	REGOP
subles	REGOP
rsbles	REGOP
addles	REGOP
adcles	REGOP
sbcles	REGOP
rscles	REGOP
tstlep	REGOP
teqlep	REGOP
cmplep	REGOP
cmnlep	REGOP
orrles	REGOP
movles	REGOP
bicles	REGOP
mvnles	REGOP
andals	REGOP
eorals	REGOP
subals	REGOP
rsbals	REGOP
addals	REGOP
adcals	REGOP
sbcals	REGOP
rscals	REGOP
tstalp	REGOP
teqalp	REGOP
cmpalp	REGOP
cmnalp	REGOP
orrals	REGOP
movals	REGOP
bicals	REGOP
mvnals	REGOP
mlas	MULT
muls	MULT
mlaeqs	MULT
muleqs	MULT
mlanes	MULT
mulnes	MULT
mlacss	MULT
mulcss	MULT
mlahss	MULT
mulhss	MULT
mlaccs	MULT
mulccs	MULT
mlalos	MULT
mullos	MULT
mlamis	MULT
mulmis	MULT
mlapls	MULT
mulpls	MULT
mlavss	MULT
mulvss	MULT
mlavcs	MULT
mulvcs	MULT
mlahis	MULT
mulhis	MULT
mlalss	MULT
mullss	MULT
mlages	MULT
mulges	MULT
mlalts	MULT
mullts	MULT
mlagts	MULT
mulgts	MULT
mlales	MULT
mulles	MULT
mlaals	MULT
mulals	MULT
swpeqb	SWAP
swpneb	SWAP
swpcsb	SWAP
swphsb	SWAP
swpccb	SWAP
swplob	SWAP
swpmib	SWAP
swpplb	SWAP
swpvsb	SWAP
swpvcb	SWAP
swphib	SWAP
swplsb	SWAP
swpgeb	SWAP
swpltb	SWAP
swpgtb	SWAP
swpleb	SWAP
swpalb	SWAP
ldreqb	TRANS
streqb	TRANS
ldrneb	TRANS
strneb	TRANS
ldrcsb	TRANS
strcsb	TRANS
ldrhsb	TRANS
strhsb	TRANS
ldrccb	TRANS
strccb	TRANS
ldrlob	TRANS
strlob	TRANS
ldrmib	TRANS
strmib	TRANS
ldrplb	TRANS
strplb	TRANS
ldrvsb	TRANS
strvsb	TRANS
ldrvcb	TRANS
strvcb	TRANS
ldrhib	TRANS
strhib	TRANS
ldrlsb	TRANS
strlsb	TRANS
ldrgeb	TRANS
strgeb	TRANS
ldrltb	TRANS
strltb	TRANS
ldrgtb	TRANS
strgtb	TRANS
ldrleb	TRANS
strleb	TRANS
ldralb	TRANS
stralb	TRANS
